-13
14
-10
15
111111111111111111111111111
100000000000000000000000001
100011111111111111111110001
100010110000000000011010001
100010110000000000011010001
100010110000000000011010001
100010000000000000000010001
100011111100000001111110001
100011111100000001111110001
100011000100000001000110001
100011111100000001111110001
100010000000000000000010001
100011111111001111111110001
100011111111001111111110001
100000000000000000000000001
100000000000000000000000001
100000000000000000000000001
100000000000000000000000001
100000000000000000000000001
100000000000000000000000001
100000000000000000000000001
100000000000000000000000001
100000000000000000000000001
111111111111111111111111111
111111111111111111111111111
