-11
11
-8
9
0000000000000000100001
0000000000000000100001
0000000000000000111111
1111111000000000111111
1111111000000000000000
1111111000000000000000
1111111100000000000000
1111111100000000000100
1111111111000000000000
1111111000000000000100
0000000000000000000000
0000000000000000000000
0000000000000000000000
0000000000000000000000
0000000000000000000000
1000000000000000000111
1000000000000000000111
