-25
23
-16
16
000000000000000000000000000000000000000000000000
000000000000000000000000000000000000000000000000
000000011111110000000000000000000000000000000000
000000011111110000000000000000000000000000000000
000000011111110000000000000000000000000000000000
010000011111110000000000010000000000000000000000
010001011111110000000000010000000000000000000000
000001011111110000000000000000100001000000000000
000000011111110000000000000000100001000000000000
000000000000000000000000000000111111000000000000
111111100000001111111000000000111111000000000000
111111100000001111111000000000000000000000000000
111111100000001111111000000000000000000000000000
111111100000001111111100000000000000000000000000
111111100001001111111100000000000100000000000000
111111101001001111111111000000000000000000000000
111111101000001111111000000000000100000000000000
000000000000000000000000000000000000000000000000
000000000000000000000000000000000000000000000000
000000000000000000000000000000000000000000000000
000000000000000000000000000000000000000000000000
000000000000000000000000000000000000000000000000
000000000000001000000001111111000111000000000000
000000000000001000000001111111000111000000000000
000000000000000000000001111111000000000000000000
000000000000000000000001111111000000000000000000
010101010000000000000001111111000000000000000000
000000000000000000000101111111000000000000000000
010101010000000000000101111111000000000000000000
000000000000000000000000000000000000000000000000
010101010000000000000000000000000000000000000000
000000000000000000000000000000000000000000000000
