-17
14
-11
10
1111111111111111111111111111111
1000000000000000000000000000001
1000000000000000000000000000001
1001100000000000000000000011001
1001100000000000000000000011001
1001100000000000000000000011001
1000000000000000000000000000001
1000000000000000000000000000001
1000000000000011100000000000001
1000000000000011100000000000001
1000000000000011100000000000001
1000000000000011100000000000001
1000000000000000000000000000001
1000000000000000000000000000001
1000000000000000000000000000001
1001100000000000000000000011001
1001100000000000000000000011001
1001100000000000000000000011001
1000000000000000000000000000001
1000000000000000000000000000001
1111111111111111111111111111111
