-25
24
-16
16
0000000000000000000000000000000000000000000000000
0000000000000000000000000000000000000000000000000
0000000111111100000000000000000000000000000000000
0000000111111100000000000000000000000000000000000
0000000111111100000000000000000000000000000000000
0100000111111100000000000100000000000000000000000
0100010111111100000000000100000000000000000000000
0000010111111100000000000000001000010000000000000
0000000111111100000000000000001000010000000000010
0000000000000000000000000000001111110000000000010
1111111000000011111110000000001111110000000000000
1111111000000011111110000000000000000000000000000
1111111000000011111110000000000000000000000000000
1111111000000011111111000000000000000000000000000
1111111000010011111111000000000001000000000000000
1111111010010011111111110000000000000000000000000
1111111010000011111110000000000001000000000000000
0000000000000000000000000000000000000000000000000
0000000000000000000000000000000000000000000000000
0000000000000000000000000000000000000000000000000
0000000000000000000000000000000000000000000000000
0000000000000000000000000000000000000000000000000
0000000000000010000000011111110001110000000000000
0000000000000010000000011111110001110000000000000
0000000000000000000000011111110000000000000000000
0000000000000000000000011111110000000000000000000
0101010100000000000000011111110000000000000000000
0000000000000000000001011111110000000000000000000
0101010100000000000001011111110000000000000000000
0000000000000000000000000000000000000000000000000
0101010100000000000000000000000000000000000000000
0000000000000000000000000000000000000000000000000
