-25
25
-16
17
00000000000000000000000000000000000000000000000000
00000000000000000000000000000000000000000000000000
00000000000011111111111111111111111111100000000000
00000000000010000000000000000000000000100000000000
00000000000010001111111111111111111000100000000000
00000000000010001011000000000001101000100000000000
00000000000010001011000000000001101000100000000000
00000000000010001011000000000001101000100000000000
00000000000010001000000000000000001000100000000000
00000000000010001111110000000111111000100000000000
00000000000010001111110000000111111000100000000000
00000000000010001100010000000100011000100000000000
00000000000010001111110000000111111000100000000000
00000000000010001000000000000000001000100000000000
00000000000010001111111100111111111000100000000000
00000000000010001111111100111111111000100000000000
00000000000010000000000000000000000000100000000000
00000000000010000000000000000000000000100000000000
00000000000010000000000000000000000000100000000000
00000000000010000000000000000000000000100000000000
00000000000010000000000000000000000000100000000000
00000000000010000000000000000000000000100000000000
00000000000010000000000000000000000000100000000000
00000000000010000000000000000000000000100000000000
00000000000010000000000000000000000000100000000000
00000000000011111111111111111111111111100000000000
00000000000011111111111111111111111111100000000000
00000000000000000000000000000000000000000000000000
00000000000000000000000000000000000000000000000000
00000000000000000000000000000000000000000000000000
00000000000000000000000000000000000000000000000000
00000000000000000000000000000000000000000000000000
00000000000000000000000000000000000000000000000000
