-26
24
-18
20
00000000000000000000000000000000000000000000000000
00000000000000000000000000000000000000000000000000
11111111111111111111111111111111111111111111111111
11100000000000000000000000000111000000000001111111
11100000000000000000000000000111000000000001111111
11100000000000000000000000000111000000000000111111
11100000000000000000000000000111000000000001111111
11100000000000000000000000000111000000000001111111
11100000000000000000000000000111000000000001111111
11100000000000000000000000000111000000000001111111
11100000000000000000000000000111000000000001111110
11100000000000000000000000000111000000000000000000
11100000000000000000000000000111000000000000000000
11100000000000000000000000000111000000000000000000
11100000000000000000000000000111000000000000000000
11100000000000000000000000000111000000000000000000
11100000000000000000000000000111000000000000000000
11111110001111111111111111111111000000000000000000
11111110001111111111111111111111000000000000000000
11111110001111111111111111111111000000000000000000
00000000000000000000000000000000000000000000000000
00000000000000000000000000000000000000000000000000
00000000000000000000000000000000000000000000000000
00000000000000000000000000000000000000000000000000
00000000000000000000000000000000000000000000000000
00000000000000000000000000000000000000000000000000
00000000000000000000000000000000000000000000000000
00000000000000000000000000000000000000000000000000
00000000000000000000000000000000000000000000000000
00000000000000000000000000000000000000000000000000
00000000000000000000000000000000000000000000000000
00000000000000000000000000000000000000000000000000
00000000000000000000000000000000000000000000000000
00000000000000000000000000000000000000000000000000
00000000000000000000000000000000000000000000000000
00000000000000000000000000000000000000000000000000
00000000000000000000000000000000000000000000000000
00000000000000000000000000000000000000000000000000
